saknas	[post]
negativt	[post]
osannolikt	[post]
inget avvikande	[post]
förnekas	[post]
inte	[pren]
ej	[pren]
ingen	[pren]
utan	[pren]
inga	[pren]
inget	[pren]
har inte	[pren]
inga tecken	[pren]
kan inte	[pren]
inte har	[pren]
utesluta	[pren]
förnekar	[pren]
inte kan	[pren]
icke	[pren]
aldrig	[pren]
saknar	[pren]
uteslutas	[pren]
patienten inte	[pren]
känner sig inte	[pren]
utan några	[pren]
kunde inte	[pren]
inte kunnat	[pren]
utan tecken	[pren]
inte visar	[pren]
inte kunna	[pren]
inget som	[pren]
fri från	[pren]
avsaknad av	[pren]
vet inte	[pseu]
inte vet	[pseu]
kan inte uteslutas	[pseu]
inte bara	[pseu]
inte utesluta	[pseu]
inte orsaka	[pseu]
inte nödvändigtvis	[pseu]
ingen ändring	[pseu]
ingen förändring	[pseu]